                     ------------                 
                   ##....._.....|                 
                     |...........#          ------
                    #...........|           |....|
---------------   ###------------           |...(|
|..%...........|##########               ###-@...|
|...%...........###    #                 ## |....|
+.......<......|       ###              ### |..!.|
---------------          #              #   ------
                         ###          ###         
                           #          #           
                        ---.-----   ###           
                        |.......|   #             
                        |........####             
                        |.......|                 
                        |.......|                 
                        ---------                 
